w,w,w,w,w,w,w,g,w,g,w,w,w,w,g,w,w,w,w,w,w,w,w,g,w,w,g,w,g,w,g,w,w,w,w,w,w,w,w,g,w,g,w,w,g,
g,w,g,w,g,w,w,w,g,w,g,g,w,w,g,g,g,w,g,g,w,w,w,w,w,w,w,w,g,g,w,w,w,w,w,w,w,w,w,w,w,g,w,w,w,
w,w,w,w,w,g,w,w,g,w,w,w,w,g,g,w,w,g,w,w,w,w,w,w,w,g,w,w,w,w,w,w,g,w,w,g,g,w,w,g,w,w,g,w,w,
g,w,w,g,g,g,w,g,w,w,g,w,w,w,w,g,g,w,g,g,w,w,w,w,g,w,g,g,w,w,g,w,w,w,w,w,g,w,w,w,w,g,w,w,w,
w,g,g,w,w,w,g,w,w,w,w,g,w,w,g,w,w,w,g,w,w,w,g,w,w,w,w,w,w,g,w,g,w,g,w,w,w,w,w,w,g,w,w,w,w,
g,w,w,w,w,w,w,w,w,w,w,w,g,w,w,w,w,w,w,w,w,g,w,w,w,g,g,w,g,g,w,g,w,g,w,w,g,w,g,w,w,w,w,g,g,
w,g,w,w,w,w,g,w,w,g,w,w,w,w,w,g,g,w,w,w,w,g,w,w,w,w,g,g,w,g,w,g,w,w,g,w,g,g,g,g,w,w,w,w,g,
w,g,w,w,w,w,w,w,w,w,w,w,w,g,w,w,w,w,w,w,g,w,w,g,g,w,w,w,w,g,g,w,w,g,g,g,w,g,g,g,w,w,w,w,w,
w,g,w,w,w,w,w,w,w,w,g,w,g,w,w,w,g,g,g,w,g,w,g,w,w,w,w,w,w,w,g,w,w,g,w,w,g,w,w,w,w,w,g,g,w,
w,g,w,w,g,w,w,g,g,g,w,g,g,w,g,g,g,w,g,g,w,w,w,w,w,w,w,w,g,w,w,w,w,w,w,w,g,w,w,g,w,w,w,w,w,
g,g,w,w,w,g,g,w,w,w,w,w,w,w,w,w,g,w,g,g,g,g,w,w,w,w,g,g,w,w,w,w,w,g,w,w,w,w,w,g,w,w,w,g,w,
w,w,w,w,w,w,w,w,w,w,w,g,w,w,w,g,w,w,w,w,w,g,w,w,g,w,w,w,w,g,w,w,w,w,w,w,w,w,w,w,g,g,w,w,w,
w,w,w,w,w,w,g,w,w,w,w,w,w,w,w,g,w,w,w,w,w,w,w,w,g,g,w,w,g,w,w,w,w,g,w,g,w,g,w,w,w,w,w,g,w,
w,g,g,g,w,w,w,w,w,w,w,w,w,g,w,w,w,w,g,g,g,w,w,g,w,w,w,w,g,g,w,g,w,w,w,w,w,w,g,w,w,w,g,g,w,
g,w,w,w,w,g,w,w,w,w,g,w,w,w,w,w,w,g,w,w,w,g,w,w,w,w,w,w,w,w,w,w,w,g,g,w,w,g,w,w,w,w,g,g,g,
w,g,g,w,g,w,w,w,w,w,w,w,w,w,w,w,w,g,g,w,w,w,w,g,w,g,g,w,w,w,w,g,w,w,g,w,w,w,w,w,g,w,w,w,w,
w,w,g,w,g,w,g,g,w,w,g,w,w,w,w,w,g,w,w,g,w,w,g,g,g,w,g,g,w,w,w,w,w,w,w,w,w,w,w,g,w,g,w,g,w,
w,g,w,g,g,w,g,w,g,w,w,w,g,w,w,w,w,w,g,w,w,g,w,g,g,g,w,w,w,w,w,w,g,w,w,w,g,g,w,w,w,w,w,w,g,
w,g,g,w,w,w,w,w,w,w,g,w,w,w,w,w,w,w,g,g,w,w,w,w,g,w,w,w,w,w,w,w,w,g,w,g,w,w,g,g,w,g,w,w,w,
w,g,w,g,g,w,w,w,g,w,w,w,w,w,w,g,w,w,w,w,w,w,w,w,w,w,w,g,g,g,w,g,w,w,w,w,w,w,w,w,w,w,w,g,w,
g,w,w,w,w,w,w,w,w,g,g,w,w,g,g,w,g,g,w,w,w,w,g,g,w,w,w,g,w,w,w,w,w,w,w,w,g,w,g,w,g,g,w,w,g,
w,w,w,w,g,w,g,w,w,g,w,w,g,w,w,w,w,g,g,w,w,g,w,g,w,g,w,w,g,w,w,w,w,g,w,g,g,w,w,w,w,w,w,w,w,
w,w,g,w,w,w,w,w,w,w,g,w,w,w,g,w,w,w,w,g,w,g,w,w,w,w,w,g,w,w,w,w,w,w,w,w,w,w,g,w,w,w,w,g,g,
w,g,w,g,g,g,w,g,g,w,w,g,w,w,w,g,w,w,w,w,g,w,w,g,g,w,w,w,w,g,w,g,w,w,g,g,g,w,w,w,w,w,w,w,w,
w,w,g,g,w,g,g,g,g,w,g,w,w,g,w,w,w,g,w,g,w,w,w,w,w,w,w,w,w,w,g,w,g,w,w,g,g,g,w,w,w,w,w,w,w,
w,w,g,w,g,w,w,w,w,g,w,g,w,w,w,w,w,w,w,w,g,w,w,w,w,w,w,w,w,w,g,g,w,w,w,w,w,w,w,w,g,g,g,g,w,
w,w,w,g,w,w,w,g,g,w,g,w,w,w,w,w,g,w,g,w,w,w,w,w,w,g,g,g,g,w,w,w,g,w,w,w,w,g,w,w,w,g,w,w,w,
g,g,w,w,w,w,g,w,w,g,w,w,w,g,w,w,w,g,w,w,g,w,g,w,g,g,w,w,w,g,w,w,w,w,g,g,w,w,w,w,g,w,w,w,w,
w,g,w,w,w,w,w,w,w,w,w,w,w,w,w,w,w,w,w,w,w,w,w,g,w,w,g,g,w,w,w,w,g,g,w,w,w,w,w,w,w,w,w,w,w,
w,w,w,w,w,w,g,w,w,g,g,w,w,w,w,w,w,g,w,g,w,w,w,w,w,w,w,w,w,w,w,w,w,w,w,w,w,w,w,w,w,g,g,g,w,
w,w,w,w,g,g,w,w,w,w,w,g,w,g,w,g,w,w,w,g,w,w,w,w,w,w,g,w,w,w,w,w,w,g,w,w,g,w,g,g,g,w,w,g,g,
g,g,w,w,g,g,w,g,w,w,w,w,w,w,w,g,g,w,g,g,w,w,g,w,w,g,w,w,w,w,w,g,g,g,w,g,w,g,w,g,g,g,g,w,w,
w,g,w,g,w,w,g,w,g,g,w,w,w,g,w,w,w,g,g,w,w,g,w,w,w,w,w,w,w,w,g,w,w,w,g,w,w,w,w,w,g,w,w,g,g,
